37 37 37 37 37 37 37 37 37 36 45 47 47 47 47 47 47 47 47 47 47 47 47 47 47 47 47 44 36 37 37 37 37 37 37 37 37 37 86 86 86 86 86 86 86 86 86 86 86 86 86 86 86 86 86 86 86 86 86 86 
37 37 37 37 37 37 37 37 37 36 45 40 41 39 39 39 39 39 39 39 39 39 39 39 39 39 39 44 36 37 37 37 37 37 37 37 37 37 86 86 86 86 86 86 86 86 86 86 86 86 86 86 86 86 86 86 86 86 86 86 
37 37 37 37 37 37 37 37 37 36 45 42 43 38 38 38 38 38 38 38 38 38 38 38 38 38 38 44 36 37 37 37 37 37 37 37 37 37 86 86 86 86 86 86 86 86 86 86 86 86 86 86 86 86 86 86 86 86 86 86 
37 37 37 37 37 37 37 37 37 36 45 48 50 37 37 37 37 37 37 37 37 37 37 37 37 37 37 44 36 37 37 37 37 37 37 37 37 37 86 86 86 86 86 86 86 86 86 86 86 86 86 86 86 86 86 86 86 86 86 86 
37 37 37 37 37 37 37 37 37 36 45 48 50 37 37 37 37 37 37 37 37 37 37 59 58 57 37 44 36 37 37 37 37 37 37 37 37 37 86 86 86 86 86 86 86 86 86 86 86 86 86 86 86 86 86 86 86 86 86 86 
37 37 37 37 37 37 37 37 37 36 45 48 50 37 37 37 37 37 37 37 37 37 37 54 55 56 37 44 36 37 37 37 37 37 37 37 37 37 86 86 86 86 86 86 86 86 86 86 86 86 86 86 86 86 86 86 86 86 86 86 
37 37 37 37 37 37 37 37 37 36 45 48 51 53 53 53 53 53 53 53 53 53 53 53 53 60 37 44 36 37 37 37 37 37 37 37 37 37 86 86 86 86 86 86 86 86 86 86 86 86 86 86 86 86 86 86 86 86 86 86 
37 37 37 37 37 37 37 37 37 36 45 49 52 52 52 52 52 52 52 52 52 52 52 52 72 50 37 44 36 37 37 37 37 37 37 37 37 37 86 86 86 86 86 86 86 86 86 86 86 86 86 86 86 86 86 86 86 86 86 86 
37 37 37 37 37 37 37 37 37 36 45 37 37 37 37 37 37 37 37 37 37 37 37 37 48 50 37 44 36 37 37 37 37 37 37 37 37 37 86 86 86 86 86 86 86 86 86 86 86 86 86 86 86 86 86 86 86 86 86 86 
37 37 37 37 37 37 37 37 37 36 45 37 37 37 37 37 37 37 37 37 37 37 37 37 48 50 37 44 36 37 37 37 37 37 37 37 37 37 86 86 86 86 86 86 86 86 86 86 86 86 86 86 86 86 86 86 86 86 86 86 
37 37 37 37 37 37 37 37 37 36 45 37 37 37 37 37 37 37 37 37 37 37 37 37 48 51 53 44 36 37 37 37 37 37 37 37 37 37 86 86 86 86 86 86 86 86 86 86 86 86 86 86 86 86 86 86 86 86 86 86 
37 37 37 37 37 37 37 37 37 36 45 37 37 37 37 37 37 37 37 37 37 37 37 37 49 52 52 44 36 37 37 37 37 37 37 37 37 37 86 86 86 86 86 86 86 86 86 86 86 86 86 86 86 86 86 86 86 86 86 86 
37 37 37 37 37 37 37 37 37 36 45 37 37 37 37 37 37 37 37 37 37 37 37 37 37 37 37 44 36 37 37 37 37 37 37 37 37 37 86 86 86 86 86 86 86 86 86 86 86 86 86 86 86 86 86 86 86 86 86 86 
37 37 37 37 37 37 37 37 37 36 47 46 46 46 46 46 46 46 46 46 46 46 46 46 46 46 46 47 36 37 37 37 37 37 37 37 37 37 86 86 86 86 86 86 86 86 86 86 86 86 86 86 86 86 86 86 86 86 86 86 
37 37 37 37 37 37 37 37 37 36 36 36 36 36 36 36 36 36 36 36 36 36 36 36 36 36 36 36 36 37 37 37 37 37 37 37 37 37 86 86 86 86 86 86 86 86 86 86 86 86 86 86 86 86 86 86 86 86 86 86 
37 37 37 37 37 37 37 37 37 37 37 37 37 37 37 37 37 37 37 37 37 37 37 37 37 37 37 37 37 37 37 37 37 37 37 37 37 37 86 86 86 86 86 86 86 86 86 86 86 86 86 86 86 86 86 86 86 86 86 86 
37 37 37 37 37 37 37 37 37 37 37 37 37 37 37 37 37 37 37 37 37 37 37 37 37 37 37 37 37 37 37 37 37 37 37 37 37 37 86 86 86 86 86 86 86 86 86 86 86 86 86 86 86 86 86 86 86 86 86 86 
37 37 37 37 37 37 37 37 37 37 37 37 37 37 37 37 37 37 37 37 37 37 37 37 37 37 37 37 37 37 37 37 37 37 37 37 37 37 86 86 86 86 86 86 86 86 86 86 86 86 86 86 86 86 86 86 86 86 86 86 
37 37 37 37 37 37 37 37 37 37 37 37 37 37 37 37 37 37 37 37 37 37 37 37 37 37 37 37 37 37 37 37 37 37 37 37 37 37 86 86 86 86 86 86 86 86 86 86 86 86 86 86 86 86 86 86 86 86 86 86 
37 37 37 37 37 37 37 37 37 37 37 37 37 37 37 37 37 37 37 37 37 37 37 37 37 37 37 37 37 37 37 37 37 37 37 37 37 37 86 86 86 86 86 86 86 86 86 86 86 86 86 86 86 86 86 86 86 86 86 86 

