0 0 0 0 0 0 3 4 5 6 7 0 0 0 0 0
0 0 0 0 0 0 12 11 10 9 8 0 0 0 0 0
0 0 0 0 0 0 13 14 15 16 17 0 0 0 0 0
0 18 18 0 0 0 0 2 2 2 0 25 0 0 0 0
0 18 18 0 0 0 0 2 2 2 0 25 0 0 0
0 0 0 0 0 0 0 2 2 2 0 27 23 23 0 0
0 0 0 0 0 0 0 2 2 2 0 26 24 24 0 0
0 0 0 0 0 0 0 2 2 2 0 0 0 0 0 0
0 19 20 0 0 0 0 2 2 2 0 0 0 0 0 0
0 21 22 0 1 1 1 2 2 2 1 1 0 0 0 0
0 0 0 0 1 1 1 2 2 2 1 1 0 0 0 0
0 0 0 0 1 1 1 2 2 2 1 1 0 0 0 0
